# Selected Tissues


## microwell-seq (wells)

aortaEndo = c("Vascular endothelial cell(Neonatal-Heart)", "Endothelial cell_Eln high(Neonatal-Heart)", "Endothelial cell_Enpp2 high(Neonatal-Heart)", "Endothelial cell_Igfbp5 high(Neonatal-Heart)")
aortaEpi = c("Epithelial cell(Neonatal-Heart)")

lungEndo = c("Endothelial cell_Kdr high(Lung)", "Endothelial cell_Tmem100 high(Lung)", "Endothelial cells_Vwf high(Lung)")
lungEpi = c("Epithelial cell_Sftpc high(Fetal_Lung)", "Epithelial cell_Aldh1a2_high(Fetal_Lung)")

lintEndo = c("Enteroendocrine(Fetal_Intestine)", "Endothelial cell(Fetal_Intestine)")
lintEpi = c("Epithelium of small intestinal villi_Fabp1 high(Small-Intestine)",
"Columnar epithelium(Small-Intestine)",
"Epithelium of small intestinal villi_Fabp6 high(Small-Intestine)",
"Epithelial cell_Kcne3 high(Small-Intestine)",
"Epithelial cell_Sh2d6 high(Small-Intestine)",
"Epithelium of small intestinal villi_S100g high(Small-Intestine)",
"Epithelium of small intestinal villi_Gm23935 high(Small-Intestine)",
"Epithelium of small intestinal villi_mt-Nd1 high(Small-Intestine)")

kidneyEndo = c("Endothelial cell(Kidney)","Fenestrated endothelial cell_Plvap high(Kidney)", "Fenestrated endothelial cell_Tm4sf1 high(Kidney)" )
kidneyEpi = c("Ureteric epithelium(Kidney)", "Epithelial cell_Cryab high(Kidney)", "Glomerular epithelial cell_Aldh1a2 high(Fetal_Kidney)")

bladderEndo = c("Urothelium(Bladder)", "Vascular endothelial cell(Bladder)","Endothelial cell_Ly6c1 high(Bladder)")
bladderEpi = c("Basal epithelial cell(Bladder)", "Epithelial cell_Upk3a high(Bladder)", "Epithelial cell_Gm23935 high(Bladder)")

liverEndo = c("Endothelial cell(Liver)")
liverEpi = c("Epithelial cell(Liver)", "Epithelia cell_Spp1 high(Liver)")

## FACS (facs)

facsAortaEndo = c("Aorta.endothelial cell")
facsAortaEpi = c("Aorta.erythrocyte")

facsLungEndo = c("Lung.lung endothelial cell")
facsLungEpi = c("Lung.epithelial cell of lung")

facsLintEndo = c("Large_Intestine.enterocyte of epithelium of large intestine")
facsLintEpi = c("Large_Intestine.epithelial cell of large intestine")

facsKidneyEndo = c("Kidney.endothelial cell")
facsKidneyEpi = c("Kidney.kidney collecting duct epithelial cell","Kidney.epithelial cell of proximal tubule")

facsBladderEndo = c("Bladder.bladder urothelial cell")
facsBladderEpi = c("Bladder.bladder cell")

facsLiverEndo = c("Liver.endothelial cell of hepatic sinusoid")
facsLiverEpi = c("Liver.hepatocyte")

## Droplet (droplet)

dropletAortaEndo = c("Heart_and_Aorta.endothelial cell", "Heart_and_Aorta.fibroblast")
dropletAortaEpi = c("Heart_and_Aorta.endocardial cell")

dropletLungEndo = c("Lung.lung endothelial cell")
dropletLungEpi = c("Lung.stromal cell")

dropletKidneyEndo = c("Kidney.kidney capillary endothelial cell")
dropletKidneyEpi = c("Kidney.kidney collecting duct epithelial cell",
                     "Kidney.kidney proximal straight tubule epithelial cell",
                     "Kidney.kidney loop of Henle ascending limb epithelial cell"
                     )

dropletBladderEndo = c("Bladder.bladder urothelial cell", "Bladder.endothelial cell")
dropletBladderEpi = c("Bladder.bladder cell")

dropletLiverEndo = c("Liver.endothelial cell of hepatic sinusoid")
dropletLiverEpi = c("Liver.duct epithelial cell", "Liver.hepatocyte")
